NO ./rsrcs/sprites/wall/flower.png
SO ./rsrcs/sprites/wall/iron2.png
WE ./rsrcs/sprites/wall/brick4.png
EA ./rsrcs/sprites/wall/red_brick.png

DO ./rsrcs/sprites/door/iron_door.png

F  58 , 157 , 35
C  119 , 181 , 254

F  0,0,0
C  80, 0, 0


        1111111111111111111111111
        1000000000110000000000001
        1011000001110000000000001
        1001000000000000000000001
111111111011000001110000000000001
10000010001100000111D111111111111
111101 1111111011100010010001
111101111111110111011 10D0001
11000000110101011100010010001
10000000000000001100000010001
10000000000000001101010010001
11000001110101011111011110N0111   111
11110111 1110101 101111010001     101
11111111 1111111 111111111111     111
