NO /rsrcs/wall/wall1.png
SO /rsrcs/wall/wall2.png
WE /rsrcs/wall/wall3.png
EA /rsrcs/wall/wall4.png

F 255,100,255
C 100,0,100


        1111111111111111111111111
        1000000000110000000000001
        1011000001110000000000001
        1001000000000000000000001
111111111011000001110000000000001
100000100011000001110111111111111
111101 1111111011100010010001
111101111111110111011 10010001
11000000110101011100010010001
10000000000000001100000010001
10000000000000001101010010001
11000001110101011111011110N0111   111
11110111 1110101 101111010001     101
11111111 1111111 111111111111     111
